11111111111111111111111111111111111111111111111111111111
10000000000000000000000000000000010100010100000000000001
100E0000000000000000000000000000010101010101111111111101
10000000000000CCC000000CCCCCCCC0010101010101000000000001
100000000000CCC000000CCC0000CCC0010001010101111111111101
1000000000CCC0CCC000000000CCC0000111110101010000000000C1
10000000CCC00CCC0000000CCC00000001000000C001011111111101
100000CCCCCCCCCCC000CCC000000000010111010101000000000101
10000000000CCC0000CCC00000000000010101010101111111110101
1000000000CCC000CCCCCCCC00C00000010101010100000000010101
100000000000000000000000000000C0010101010111111111110101
1000000000000000000000000000000001C000010000000000000101
10000100111101100001001111011000010111111111111111111101
10000000000000000000000000000000000100P00000000000C00001
11111111111111111111111111111111111111111111111111111111